laby.Labyrinth([
    [2, 12, 6, 8, 2, 14, 10, 8, 2, 14, 8, 4, 2, 12, 2, 12, 4, 4, 4, 4],
    [4, 3, 13, 4, 4, 7, 8, 4, 4, 7, 10, 9, 4, 3, 14, 15, 9, 7, 9, 5],
    [3, 14, 9, 5, 5, 7, 8, 5, 3, 13, 4, 2, 11, 14, 9, 3, 10, 11, 10, 13],
    [2, 15, 8, 7, 9, 7, 10, 9, 4, 7, 11, 10, 8, 7, 10, 10, 10, 10, 12, 1],
    [2, 15, 10, 11, 8, 7, 10, 10, 9, 5, 6, 14, 8, 7, 12, 4, 6, 8, 3, 12],
    [4, 5, 6, 12, 6, 9, 2, 12, 4, 7, 9, 7, 10, 13, 3, 11, 11, 12, 4, 1],
    [7, 11, 13, 1, 7, 10, 8, 3, 13, 5, 4, 3, 8, 3, 10, 8, 4, 1, 7, 8],
    [5, 4, 3, 10, 9, 4, 2, 10, 15, 9, 7, 10, 8, 6, 10, 10, 9, 4, 7, 8],
    [7, 11, 14, 14, 14, 15, 14, 10, 15, 14, 11, 8, 6, 9, 2, 12, 4, 7, 11, 8],
    [5, 6, 9, 1, 5, 1, 1, 4, 5, 3, 8, 4, 5, 4, 2, 15, 9, 5, 4, 4],
    [5, 3, 8, 2, 15, 10, 14, 9, 3, 14, 10, 11, 13, 7, 10, 9, 4, 7, 9, 5],
    [7, 14, 8, 6, 11, 8, 7, 10, 8, 7, 14, 12, 3, 15, 10, 14, 9, 7, 10, 13],
    [5, 3, 8, 7, 14, 8, 7, 10, 8, 5, 1, 1, 2, 9, 2, 15, 10, 11, 8, 1],
    [5, 2, 14, 13, 7, 8, 3, 8, 6, 15, 10, 10, 14, 14, 8, 7, 10, 14, 8, 4],
    [7, 12, 1, 1, 3, 14, 14, 8, 5, 7, 14, 12, 1, 7, 8, 3, 8, 3, 14, 9],
    [1, 7, 10, 8, 2, 9, 7, 8, 1, 1, 1, 3, 8, 3, 14, 14, 12, 2, 15, 12],
    [6, 15, 14, 8, 4, 4, 3, 14, 14, 10, 10, 14, 10, 8, 1, 5, 3, 8, 1, 5],
    [5, 1, 7, 8, 5, 7, 8, 5, 5, 6, 10, 15, 14, 12, 6, 11, 14, 8, 2, 13],
    [7, 12, 5, 6, 11, 15, 12, 1, 5, 1, 6, 13, 1, 1, 7, 12, 7, 8, 6, 13],
    [1, 1, 3, 11, 8, 1, 1, 2, 9, 2, 9, 1, 2, 10, 9, 1, 1, 2, 9, 1]
])